....................
....................
....................
....................
GGGS................
#####...............
...-------...GGG....
...........#####....
..G.F.G.............
..-------...........
............GDG.....
...........-----....
....................
.1........C......X..
####################
