....................
.X..................
##--................
....................
---------...........
.............D.G.F.G
.............#######
......D.GGG.........
......######........
S..G................
---##...............
................GGG.
...............#####
.1..............C...
####################
