....................
....................
........GDGG........
.......######.......
..G..............X..
####....----...-----
.........S..........
......--------......
...--...........--..
....................
.F.G............G.GC
##--............----
....................
.1..................
####################
